NO ./textures/gucci.xpm
SO ./textures/kfc.xpm
EA ./textures/bvlgari.xpm
WE ./textures/louis.xpm

F 255,228,199
C 153,236,255

1111111111111111111111111
1000000000011100000000001
1000000000000000000100001
1000000000000000000100001
1000000000000000000100001
10000001D1111111111100001
1000000100000000000000001
100000010000E0X0000000001
1000000100000000000000001
1000000100000000000000001
1000000111D11110000000001
1000000100000010000000001
1000000100000010000000001
1000000100000010000000001
1000000100000010000000001
1111111111111111111111111
