NO ./textures/gucci.xpm
SO ./textures/kfc.xpm
WE ./textures/bvlgari.xpm
EA ./textures/louis.xpm

F 255,228,199
C 153,236,255

111111111111111111111111111111111111111111111111111
100000000011000000000000000000000000000000000000001
101100000111000000000000111111111111111111D11111111
10010X0100000000000000001             1000000000001
1010000110110000011100001             1000000000X01
1011D11110110000011100001             1111111111001
10X0000110000011011011D11             1000000000001
1001011111010100000010001             100X000000001
1111011111010111000010001             1111111111111
10001101010X010X000010N01
1111111111111111111111111
