NO ./textures/gucci.xpm
SO ./textures/kfc.xpm
WE ./textures/bvlgari.xpm
EA ./textures/louis.xpm

F 255,228,199
C 153,236,255

111111111111111111111111111111111111111111111111111
100000000011000000000000D00000000000000000000000001
1001000001110000N0000000111111111111111111D11111111
10010X000D000000000000001             1000000000001
1111111111100000000000001             1000000000X01
          111111111111111             1111111111001
                                      1000000000001
                                      100X000000001
                                      1111111111111
