NO ./textures/gucci.xpm
SO ./textures/kfc.xpm
WE ./textures/bvlgari.xpm
EA ./textures/louis.xpm
EA ./textures/louis.xpm

F 255,2a28,199
C 153,236,255

ASDFG

1111111111111111111111111
1000000000011100000000001
1000000000000000000000001
1000000000000000000000001
1000000000000000000000001
1111111111111100000000001
1000E00000000000000000001
1111111111111100000000001
1000000000000000000000001
1000000000000000000000001
1000000000000000000000001
1000000000000000000000000
1000000000000000000000001
1000000000000000000000001
1000000000000000000000001
1111111111111111111111111
