NO ./textures/pink.xpm
SO ./textures/pink.xpm
WE ./textures/pink.xpm
EA ./textures/pink.xpm

F 255,105,180
C 153,236,255

1111111111111111111111111
1000000000110000000000001
1011000001110000000000001
1001000000000000000000001
101111111011000001110000111111111
101111111011000001110000000000001
100000000011000001110111111011111
11110111111111011100000000001
11110111111111011111000000001
11000000110101011100000010001
10000000000000001100000010001
10000111000000001101010010001
11000001110101011111011110N0111
11110111 1110101 101111010001
11111111 1111111 111111111111
