NO ./textures/gucci.xpm
SO ./textures/kfc.xpm
WE ./textures/bvlgari.xpm
EA ./textures/louis.xpm

F 255,228,199
C 153,236,255

111111111111111111111111111
1000000000110000000000000001
1011000001110000000000001111
1001000000000000000000001
1011111110110000011100001
1011111110110000011100001
1000000110000011011011111
1111011111011100000000001
1111011111011111000000001
1000110101011100000010N01
1000000000001100000010001
1011000000001101010010001
1001110101011101111000111
1111011111101001111010001
1111111111111111111111111
