NO ./textures/gucci.xpm
SO ./textures/kfc.xpm
EA ./textures/bvlgari.xpm
WE ./textures/louis.xpm

F 255,228,199
C 153,236,255

1111111111111111111111111
1000000000011100000000001
1000000000000000000000001
1000000000000000000000001
1000000000000000000000001
1000000100111100000000001
1000000100000000100000001
100000010000E000100000001
1000000100000000100000001
1000000111111111100000001
1000000000000000000000001
1000000000000000000000001
1000000000000000000000001
1000000000000000000000001
1000000000000000000000001
1111111111111111111111111
