NO ./textures/NO.xpm
SO ./textures/SO.xpm
WE ./textures/WE.xpm
EA ./textures/EA.xpm

F 255,105,180
C 153,236,255

1111111111111111111111111
1000000000011100000000001
1000000000000000000000001
1000000000000000000000001
1000000000000000000000001
1000000000011100000000001
1000000000000000000000001
100000000000N000000000001
1000000000000000000000001
1000000000000000000000001
1000000000000000000000001
1000000000000000000000001
1000000000000000000000001
1000000000000000000000001
1000000000000000000000001
1111111111111111111111111
