NO ./textures/gucci.xpm
SO ./textures/kfc.xpm
WE ./textures/bvlgari.xpm
EA ./textures/louis.xpm

F 255,228,199
C 153,236,255

111111111111111111111111111111111111111111111111111
100000000011000000000000000000000000000000000000001
101100X00111000000000000111111111111111111D11111111
1001000000000000000000001             1000000000001
1010000110110000011100001             1000000000X01
1011D11110110000011100001             1111111111001
10X0000110000011011011D11             1000000000001
1001011111010100000000001             100X000000001
1111011111010111000000001             1111111111111
10001101010X010X000010N01
1000000000001100000010001
101100000000D001010010001
1001000101011101111000111
100D0011000D0000100100001
10010X01000100X01000X0001
1111111111111111111111111
