NO textures/gucci.xpm
SO textures/kfc.xpm
WE textures/bvlgari.xpm
EA textures/louis.xpm

F 255,228,199
C 153,236,255

11111111
1E00X001
11111111
