NO ./textures/gucci.xpm
SO ./textures/kfc.xpm
EA ./textures/bvlgari.xpm
WE ./textures/louis.xpm

F 255,228,199
C 153,236,255

1111111111111111111111111
1000000000011100000000001
1000000000000000000100001
1000000000000X00000100001
1000000000000X00000100001
1000000111111111111100001
1000000100000000000000001
100000010000E000000000001
1000000100000000000000001
1000000100000000000000X01
1000000111111110000000001
1000000100000010000000X01
1000000100X00010000000001
1000000100000010000000001
1000000000000000000000001
1111111111111111111111111
